きどうせいせい	軌道生成	名詞	
じへん	時変	名詞	
じふへん	時不変	名詞	
れいわ	令和	名詞	
よこよく	横力	名詞	
さいきんぼう	最近傍	名詞	
ひほろのみっく	非ホロノミック	名詞	
そくおう	速応	名詞	
みちりょう	未知量	名詞	
せいじゅん	正準	名詞	
ぼかんすう	母関数	名詞	
けいかくき	計画器	名詞	
せんけいきんじ	線形近似	名詞	
にじきんじ	二次近似	名詞	
いちじきんじ	一次近似	名詞	
ぱらめとらいず	パラメトライズ	名詞	
いちけいすう	一径数	名詞	
せいせいし	生成子	名詞	
そうくうかん	相空間	名詞	
はいいくうかん	配位空間	名詞	
かんやく	簡約	名詞	
そくちば	測地場	名詞	
はんへん	反変	名詞	
そくちてき	測地的	名詞	
びぶんきか	微分幾何	名詞	
ちょうきょくめん	超曲面	名詞	
せつくうかん	接空間	名詞	
せつ	接	名詞	
せんそ	線素	名詞	
せつべくとる	接ベクトル	名詞	
